1111111111111111111111111111111
1111000000000000000111111111111
11100C000000M000C00011111111111
11100000000000M000C000000111111
1110000000000000M00000011111111
11000E000C000000000000001111111
100C00000C000000000000000000001
1CM000M0000CCCCC000000000000011
10000000000P0000000000000000001
110000C00000000M000000000000001
11100000000000000M0000000000001
111C0000M00000CC000000M00000001
111CCCCC00000000000000000000001
111C00M00000MCC1000000000000001
1110000000000000000000000001111
1111111111111111111111111111111
