1111111111111111111111111111111
1111000000000000000111111111111
11100C0000000000000011111111111
1110000000000000000000000111111
1110000000000000000000011111111
11000E000C000000000000001111111
100C00000C000000000000000000001
1CCCCCCCCCCCCCCC000000000000011
10000000000P0000000000000000001
110000C000000000000000000000001
1110000000000000000000000000001
111CCCCCCCCCCCCC000000000000001
111CCCCC00000000000000000000001
111CCCCCCCCCCCC1000000000000001
1110000000000000000000000001111
1111111111111111111111111111111
