1111111111111111111111111111111
1E00000M000000C00000C0000CM0001
101C0101001000001010010M0001111
101M0100101010100010010000M0001
1P0000000C0MC00000000000000C001
1111111111111111111111111111111
