111111111111111
10000000000M001
1000P0000000001
11000000000E001
1100000C0000001
111111111111111
