111111111111111
100000000000001
100P0000E000001
110000000000001
1100000C0000001
111111111111111
