111111111111111
100000000000001
1000P0000000001
110000000000001
1100000C0000001
111111111111111
