111111111111111111111
100000000000000000001
100000001100000100001
1000E0001100000100001
1000P0001100000100001
10000000C00000C000001
111111111111111111111
