11111111111111111
11110000000111111
11100C00000011111
11100000000001111
11100000000001111
11000E000C0001111
100C00000C0000011
1CCCCCCCCCCCCCCC1
10000000000P00001
110000C0000000001
11100000000000001
111CCCCCCCCCCCCC1
111CCCCC000000001
111CCCCCCCCCCCC11
11100000000001111
11111111111111111
