111111111111111111111111111111
101000000000000C00100C00000001
1P1001010010000010100100000001
101001001010101000100100000001
100010000C00C000000000C0000001
1111C0001111001100001110000001
100000000000000C11111C0000E111
111111111111111111111111111111
