1111111111111111111111111111111
1E1000000000000C00100C000000001
1P10010100100000101001000000011
1010010010101010001001000000011
100010000C00C000000000C000000C1
1111C00011110011000011100000011
100000000000000C11111C000111001
1111111111111111111111111111111
