111111111111111
10000000000001
100P0000E0001
110000000001
1100000C001
1111111111
