111111111111111
100000000000001
100P0000E00001
1100000000001
1100000C0000011
111111111111111
