11111111111111
10000000000001
10000P11000001
10000011000001
1000000CC00001
100000000000E1
11111111111111
