11111111111111111111111111111111
11110000000000000001111111111111
11100C00000000000000111111111111
11100000000000000000000001111111
11100000000000000000000111111111
11000E000C0000000000000011111111
100C00000C0000000000000000000011
1CCCCCCCCCCCCCCC0000000000000001
10000000000P00000000000000000001
110000C0000000000000000000000001
11100000000000000000000000000001
111CCCCCCCCCCCCC0000000000000001
111CCCCC000000000000000000000001
111CCCCCCCCCCCC10000000000000001
11100000000000000000000000001111
10000000000000000000000000000001
11111111111111111111111111111111
