111111111111111
100000000000001
000P000E0000001
110000C0000C001
110000000C00001
111111111111111
